{
    "tileset": "terrain.png",
    "map": [
        [0,0,0,0,0,0,0,2,0,0,16,0,0,0,0,0,0,0,0,0,0,0,0],
        [0,0,0,0,0,0,0,2,0,16,0,0,0,0,0,0,0,0,0,0,0,0,0],
        [0,0,0,0,0,0,0,2,16,16,6,0,0,0,0,0,0,0,0,0,0,0,0],
        [0,0,0,0,0,0,0,2,2,2,5,0,0,0,0,0,0,0,0,0,0,0,0],
        [0,0,0,0,0,0,0,2,0,16,16,0,0,0,0,0,0,0,0,0,0,0,0],
        [0,0,0,0,0,0,0,2,0,16,16,0,0,0,0,0,0,0,0,0,0,0,0],
        [0,0,0,0,0,0,0,2,16,0,6,0,0,0,0,0,0,0,0,0,0,0,0],
        [0,0,0,0,0,0,0,2,2,2,5,0,0,0,0,0,0,0,0,0,0,0,0]
    ]
}
